1111111111111
1000000000001
1000000000001
1000000000001
100000c000001
1000ccccc0001
100ccccccc001
1000ccccc0001
100000c000001
1000000000001
1000000000001
1000000000001
1111111111111