1111111111111
1aaa000000aa1
1aaa000000001
1aaa000000a01
10000af00a001
100000000a001
1000a00000001
1000000000001
1000000aaa001
100a0000aa001
10a0a0000aaa1
100a000000001
1111111111111