1111111111111
1000010100a01
1000010100e01
100e00000e001
1000010100001
1a101aea10111
100000a000001
1a101a0a10a11
100001010e001
100e00000e001
10a0010100a01
10000a0100e01
1111111111111