1111111111111
1011000000001
10e0000000e01
100aa01000001
1001a0000aa01
100010000a001
100000ee00001
10000ae000001
1a110000e0001
1000000010001
10e0a000aa001
100000000a001
1111111111111