1111111111111
10aa00000a0a1
10a0010a00a01
1aa1010a0a001
100001010aa01
1011110111101
100000e000001
11aaa00111101
1a00010aeaa01
a0aea1a10e101
1011110100e01
10a0a0000a001
1111111111111