1111111111111
10aa000001001
1011000011001
10a110000aa01
1000000001001
10aa000000001
100000f000001
1001000000001
1000d0h0v0001
100a1100a1001
100a100000001
1000000000001
1111111111111