11111111111
10111111111
11011111111
11101011111
11110111111
11101011111
11111111111
11110111111
11101110111
11111101111
11111111111
